ɑ	ɑ
m	m
q	k
u	u
o	o
ɛ	ɛ
f	f
ʑ	ʒ
x	x
ʈ	t
ŋ	ŋ
r	ɹ
a	a
ə	ə
ɕ	ʃ
g	g
s	s
k	k
ɦ	h
j	j
ɨ	ʉ
d	d
ʂ	ʃ
ɖ	d
i	i
æ	æ
e	e
ʌ	ʌ
ɯ	ʊ
y	ɪ
l	l
n	n
t	t
ʐ	ʒ
w	w
ɡ	g
ɬ	ʃ
p	p
z	z
b	b